R  1000 720

NO ./assets/BIGWINDOW.xpm
SO ./assets/BIGWINDOW.xpm
WE ./assets/BIGWINDOW.xpm
EA ./assets/BIGWINDOW.xpm

S 5 0 0  ./assets/18_midnight.xpm
S 4 2 0  ./assets/17_felspell.xpm
F ./assets/BIGWINDOW.xpm
C ./assets/skybox_night.xpm

1111111
1500051
100S001
1000001
1000001
1000001
1500051
1000001
1000001
1000001
1004001
1500051
1111111

=====
NO ./assets/BIGWINDOW.xpm
SO ./assets/BIGWINDOW.xpm
WE ./assets/BIGWINDOW.xpm
EA ./assets/BIGWINDOW.xpm

S 2 0 -20 ./assets/13_vortex.xpm
S 3 0 50  ./assets/12_nebula.xpm
S 5 0 0  ./assets/18_midnight.xpm
S 4 2 0  ./assets/17_felspell.xpm
F ./assets/BIGWINDOW.xpm
C ./assets/skybox_night.xpm

111111111111111111111
150S05111111111111111
100000111111111111111
100000111111111111111
122222100051110000051
100000150002220000001
100300000002220030401
150005150002220000001
111111100051110000051
111111111111111111111

=====
NO ./assets/SANDMARKS.xpm
SO ./assets/SANDMARKS.xpm
WE ./assets/SANDMARKS.xpm
EA ./assets/SANDMARKS.xpm

S 2 0 -20 ./assets/13_vortex.xpm
S 3 0 50  ./assets/12_nebula.xpm
S 4 2 0  ./assets/17_felspell.xpm
S a 1 0  ./assets/b_cactus.xpm
S b 1 0  ./assets/m_cactus.xpm
S c 1 0  ./assets/s_cactus.xpm
S d 0 0  ./assets/mushroom.xpm
S e 1 0  ./assets/rock.xpm
F ./assets/SAND.xpm
C ./assets/skybox_sunrise.xpm

11111111111111111111111111111111111111111111111111111111111111111
11111111110000000ee11b0S0e1a00000000d111111cbabc11111111111111111
11111111112110cc00111b000a12002001000111111d232d11111111111111111
111111111103100a0003a00400a0000bc1020111111e020e11111111111111111
111111111101202000111d00eb10e00201e101111110000011111111111111111
1111111111a11000ada11ac00a1110111122011111110001111111200ae011111
11111111111110111111111011100000110001111111101111100000001311111
111111111111101111111110111b1a101102a111111110111110110b0d0d11111
1111111111c000e1a1121e1011120000110e111a1b1c00010200c111111111111
1111111111d0bc0120002000e1100000110000000000000001000d11111111111
1111111111d2a00100a00000b113101e11b2011a1b1c0001000a0111111111111
111111111100001101101d1011111011111111111111101111111111111111111
111111111111011101111a1a11111011111111111110000011111111111111111
11111111111101110000000111020011111111111110111011111111111111111
11111111111101110021b000000000a1111111111110a00d11111111111111111
11111111111d001100111001110c0001111111111111002111111111111111111
11111111111ea0110001300001111111111111111111c00111111111111111111
1111111111100000de00000101111111111111111111100d11111111111111111
111111111111111111111111011111111111111111111b0011ed0011111111111
1111111111111111111111100e1111111111111110a011000000ad00111111111
11111111111111111113e01b00100011111110000000dd00e111111d111111111
11111111111111111110200000d02011111110110e00dd00b111111d111111111
11111111111111111110001000100a1111110001100c110001111100011111111
1111111111111111111111100e1111111110d00011111aaaaa11110b011111111
11111111111111111111111ca011111111c3e100b111000000011100011111111
11111111111111111111111111111111111002de10000433330111a0a11111111
111111111111111111111111111111111111a0011011000000011100011111111
111111111111111111111111111111111111111100a1111111111110111111111
11111111111111111111111111111111111111110210000000000000011111111
11111111111111111111111111111111111111110010001000100010011111111
111111111111111111111111111111111111111110000000a0000000011111111
11111111111111111111111111111111111111111110001000100010011111111
11111111111111111111111111111111111111111110000000000000011111111
11111111111111111111111111111111111111111111111111111111111111111
===============================
NO ./assets/PATHROCKS.xpm
SO ./assets/TALLGRASS.xpm
WE ./assets/PATHROCKS.xpm
EA ./assets/TALLGRASS.xpm

S 2 0 -20 ./assets/13_vortex.xpm
S 3 0 50  ./assets/12_nebula.xpm
S 4 2 0  ./assets/17_felspell.xpm
S a 1 0  ./assets/cherry_trees.xpm
S b 1 0  ./assets/yellow_tree.xpm
S c 0 0  ./assets/m_plants.xpm
S d 0 0  ./assets/mush.xpm
S e 1 0  ./assets/rock.xpm
F ./assets/BIGLEAVES.xpm
C ./assets/skybox_day.xpm

111111111111111111111111111111111111111111111111111
111111111111111111111111111311111111111111111111111
111111111111ec00011d010a011000aa0c00a11111110001111
111111111111d0b00000000200000200cec0011111000e01111
11111111111100020110e1ccc11000000c0e011111010001111
11111111111111011111111111111110a02000b100011111111
11111111111111011111111111111111110a020d01111111111
111111111111b0cce1a00000a0c011111111000111111111111
111111111111a0ccc1101100200011c00111101111111111111
11111111111100b0d1a0de10000d000a2111000011111111111
111111111111b0S0e1000c011111110001110cc011111111111
12110cc00111b000a1200200111111110000ccc000000000c01
103100a0003a00020a0000bc111111110111000b1110a0cca01
101202000111d00eb10e01111111111111111101111aae2b2d1
1a11000ada11ac00a1110111111111111111110111100c000c1
1111111111110cc00111111111111111111de00001101111111
111111111111e0d0a11111111111111c00000020c1101111111
111111111111accca1111111111111102111aaaa11100000c01
11111111111111011111111111111110d000c0003110a0cca01
11111111111111c111111111111c00011111aaaa111aad2b2e1
11111111111100000111110000100200cc0c000dc0000c000c1
1111111111110a02011dcbb0001a00a11111aaaa11111111111
111111111111c0300cc00b400000a0000000020001111111111
1111111111110000a11e0bb000100a1e11b1000201111111111
111111111111111111111100001b0c0000c0ab2001111111111
11111111111111111111111111111111111d020201111111111
111111111111111111111111111111111113020001111111111
111111111111111111111111111111111111000221111111111
111111111111111111111111111111111111111111111111111